Item: "Science Fiction Author to attend  Science Fiction Convention.  A proper opening will go here..."

Inferno
An Interactive Fiction by Larry Niven and Jerry Pournelle
Release 1 / Serial number 120424 / Inform 7 build 6G60 (I6/v6.32 lib 6/12N) SD

Con-Suite
This could be any hotel suite in any hotel in Anywhere USA, except this one is filled with short ugly kids with pimples, tall serious Harvard types, girls with long stringy hair, half-pretty girls half-dressed to show it, and damn few people with good manners.  

On the east side of the room is an open window.

Isaac Asimov is here, surrounded by a gaggle of fans, holding forth in a somewhat ill fitting suit.

He has acne and halitosis.

>look
Con-Suite
The Con-Suite is ...

>taiste
That's not a verb I recognise.

>run
You'll have to say which compass direction to go in.

>pray
That's not a verb I recognise.

* * *

>look
Con-Suite
The Con-Suite is ...

>walk
You'll have to say which compass direction to go in.

>east
You can't go that way.

* * *

>look
Con-Suite
The Con-Suite is ...

>look at sky
You can move, or rather you can move?  There is no place to go!

>look sky
I only understood you as far as wanting to look.

* * *

>look at sky
You can move, or rather you can move?  There is no place to go!

>shout
You shout, "For the love of God, get me out of here!"  You suddenly feel like you exist again... and look around you...

Rolling Plain
You are on a large grassy plain.  To the north you see a river and a wall, far in the distance.  To the east a large group of people seem to be chasing a kite.

A bronze Djinn Bottle is laying on the ground.

fat man is here.

>ask fat
You can only do that to something animate.

>talk
That's not a verb I recognise.

* * *

>speak to fat
I only understood you as far as wanting to speak.

>speak fat
(to yourself)
There is no reply.

>speak to benito
I only understood you as far as wanting to speak.

>examine fat
You ask the fat man who he is and he replies "I am Benito, I rescued you from the bottle."

>speak to benito
I only understood you as far as wanting to speak.

>ask benito
You can only do that to something animate.

* * *

>look
Con-Suite
The Con-Suite is ...

>pray
You beg God for to get you out of here!  You suddenly feel like you exist again... and look around you...

Rolling Plain
You are on a large grassy plain.

You can see a Djinn bottle (closed) and a heavyset man here.

>examine man
You ask the heavyset man who he is and he replies Call me Benito, I rescued you from the bottle.

>look
Rolling Plain
You are on a large grassy plain.

You can see a Djinn bottle (closed) and Benito here.

>examine sky
You can't see any such thing.

>look up
I only understood you as far as wanting to look.

>look at sky
You can't see any such thing.

* * *

>look
Con-Suite
The Con-Suite is ...

>yell
That's not a verb I recognise.

* * *

>look
Con-Suite
The Con-Suite is ...

>north
You can move, or rather you can move, but there is no where to move, so are you moving?

>shout
You shout, "for the love of God, get me out of here!"  You suddenly feel like you exist again... and look around you...

Rolling Plain
You are on a large grassy plain.

A bronze Djinn Bottle.

You can also see a heavyset man here.

>take bottle
You can move, or rather you can move, but there is no where to move, so are you moving?

>n
You can move, or rather you can move, but there is no where to move, so are you moving?

* * *

>north
You can move, or rather you can move, but there is no where to move, so are you moving?

>pray
You shout, "for the love of God, get me out of here!"  You suddenly feel like you exist again... and look around you...

Rolling Plain
You are on a large grassy plain.

A bronze Djinn Bottle.

You can also see a heavyset man here.

>pray
You shout, "for the love of God, get me out of here!"  You suddenly feel like you exist again... and look around you...

Rolling Plain
You are on a large grassy plain.

A bronze Djinn Bottle.

You can also see a heavyset man here.

>north
You can't go that way.

* * *

>look
Con-Suite
The Con-Suite is ...

>look
Bronze
All you can see is a featureless bronze nothingness.  You can't even see... yourself.

You can see a heavyset man here.

* * *

>look
Con-Suite
The Con-Suite is ...

>scream
That's not a verb I recognise.

>shout
You shout, "For the love of God, get me out of here!"  You suddenly feel like you exist again... and look around you...

Rolling Plain
You are on a large grassy plain.  To the north you see a river and a wall, far in the distance.  To the east a large group of people seem to be chasing a kite.

A bronze Djinn Bottle.

You can also see a heavyset man here.

>n
You can't go that way.

* * *

>look
Con-Suite
The Con-Suite is ...

>smell
It smells foetid, with an acrid tinge, decay and sickly sweet perfume to cover the smells of death, orange blossoms mingled with hospital smells, but sickening all the same.

* * *

>look
Con-Suite
The Con-Suite is ...

>look gnats
You can't see any such thing.

>listen
You hear nothing unexpected.

>talk to benito
You can't see any such thing.

* * *

>look
Con-Suite
The Con-Suite is ...

>who
That's not a verb I recognise.

>invent
That's not a verb I recognise.

>inventory
You are carrying nothing.

>look
Con-Suite
The Con-Suite is ...

>jump
You jump on the spot, fruitlessly.

* * *

>pray
You shout, "For the love of God, get me out of here!"  You suddenly feel like you exist again... and look around you...

Rolling Plain
You are on a large grassy plain.   To the north you see a river and a wall, far in the distance.  To the east a large group of people seem to be chasing a banner.

A bronze Djinn Bottle is laying on the ground.

You can also see a fat guy here.

The fat man says, "I am Benito, I rescued you from the bottle.  What is your name?

You have nothing specific in mind to discuss with Benito right now.

>praying
That's not a verb I recognise.

>look
Copper Nothingness
All you can see is a featureless copper expanse.

>Pray to go
That's not a verb I recognise.

* * *

>pray
You shout, "For the love of God, get me out of here!"  You suddenly feel like you exist again... and look around you...

Rolling Plain
You are on a large grassy plain.   To the north you see a river and a wall, far in the distance.  To the east a large group of people seem to be chasing a banner.

A bronze Djinn Bottle is laying on the ground.

You can also see a fat guy here.

The fat man says, "I am Benito, I rescued you from the bottle.  What is your name?

You have nothing specific in mind to discuss with Benito right now.

>look
Rolling Plain
You are on a large grassy plain.

You can see Benito here.

>e
You can't go that way.

>s
You can't go that way.

>w
You can't go that way.

* * *

>pray
You shout, "For the love of God, get me out of here!"  You suddenly feel like you exist again... and look around you...

Rolling Plain
You are on a large grassy plain.   To the north you see a river and a wall, far in the distance.  To the east a large group of people seem to be chasing a banner.

A bronze Djinn Bottle is laying on the ground.

You can also see a fat guy here.

The fat man says, "I am Benito, I rescued you from the bottle.  What is your name?

You have nothing specific in mind to discuss with Benito right now.

>look bottle
I only understood you as far as wanting to look.

>examine bottle
You can't see any such thing.

* * *

>pray
You shout, "For the love of God, get me out of here!"  You suddenly feel like you exist again... and look around you...

Rolling Plain
You are on a large grassy plain.   To the north you see a river and a wall, far in the distance.  To the east a large group of people seem to be chasing a banner.

A bronze Djinn Bottle is laying on the ground.

You can also see a fat guy here.

The fat man says, "I am Benito, I rescued you from the bottle.  What is your name?

You have nothing specific in mind to discuss with Benito right now.

>take heavyset
heavyset man resists your romantic notions...

>look
Rolling Plain
You are on a large grassy plain.  To the north you see a river and a wall, far in the distance.  To the east a large group of people seem to be chasing a kite.

A bronze Djinn Bottle is laying on the ground.

A large, square jawed man.

>examine man
You ask the heavyset man who he is and he replies "I am Benito, I rescued you from the bottle."

>talk to benito
That's not a verb I recognise.

>ask benito
You can only do that to something animate.

>ask man
You can only do that to something animate.

>w
You can't go that way.

>e
Kite Chase
Benito follows dutify behind you...

>look
Kite Chase
A large, square jawed man.

* * *

>pray
You shout, "For the love of God, get me out of here!"  You suddenly feel like you exist again... and look around you...

Rolling Plain
You are on a large grassy plain.   To the north you see a river and a wall, far in the distance.  To the east a large group of people seem to be chasing a banner.

A bronze Djinn Bottle is laying on the ground.

You can also see a fat guy here.

The fat man says, "I am Benito, I rescued you from the bottle.  What is your name?

You have nothing specific in mind to discuss with Benito right now.

>north
Wall
No matter how far you walk, the wall never seems to get any closer...

A fat man trudges along behind you...

>n
Benito says, "We could walk for eternity and never reach that wall, and we have eternity.

>n
Benito says, "We could walk for eternity and never reach that wall, and we have eternity.

* * *

>pray
You shout, "For the love of God, get me out of here!"  You suddenly feel like you exist again... and look around you...

Rolling Plain
You are on a large grassy plain.   To the north you see a river and a wall, far in the distance.  To the east a large group of people seem to be chasing a banner.

A bronze Djinn Bottle is laying on the ground.

You can also see a fat guy here.

The fat man says, "I am Benito, I rescued you from the bottle.  What is your name?

You have nothing specific in mind to discuss with Benito right now.

>examine fat
A large, fat man with a jutting jaw is here.

>t benito
There's no one here to talk to.

>t hell
There's no one here to talk to.

* * *

>examine fat
A large, fat man with a jutting jaw is here.

>n
Wall
No matter how far you walk, the wall never seems to get any closer...

Benito trudges along behind you...

>n
You continue walking north...

>n
You continue walking north...

* * *

>examine fat
A large, fat man with a jutting jaw is here.

>l
Rolling Plain
You are on a large grassy plain.  To the north you see a river and a wall, far in the distance.  To the east a large group of people seem to be chasing a kite.

A bronze Djinn Bottle is laying on the ground.

You can also see Benito here.

>examine benito
Benito is here

* * *

>pray
You shout, "For the love of God, get me out of here!"  You suddenly feel like you exist again... and look around you...

Rolling Plain
You are on a large grassy plain.   To the north you see a river and a wall, far in the distance.  To the east a large group of people seem to be chasing a banner.

A bronze Djinn Bottle is laying on the ground.

You can also see a fat guy here.

The fat man says, "I am Benito, I rescued you from the bottle.  What is your name?

You have nothing specific in mind to discuss with Benito right now.

>examine guy
You ask the fat man who he is and he replies "I am Benito, I rescued you from the bottle."

>l
Rolling Plain
You are on a large grassy plain.  To the north you see a river and a wall, far in the distance.  To the east a large group of people seem to be chasing a kite.

A bronze Djinn Bottle is laying on the ground.

Benito is here.

>t benito
(addressing Benito)
Benito does not respond.

>t hell
Benito does not respond.

>t benito hell
Benito does not respond.

* * *

>pray
You shout, "For the love of God, get me out of here!"  You suddenly feel like you exist again... and look around you...

Rolling Plain
You are on a large grassy plain.   To the north you see a river and a wall, far in the distance.  To the east a large group of people seem to be chasing a banner.

A bronze Djinn Bottle is laying on the ground.

You can also see a fat guy here.

The fat man says, "I am Benito, I rescued you from the bottle.  What is your name?

You have nothing specific in mind to discuss with Benito right now.

>t hell
(addressing the fat guy)
What did you say, allen?

>t about hell
The fat guy does not respond.

>ask about hell
The fat guy does not respond.

>tell
What do you want to tell the fat guy about?

>tell hell
You can't see any such thing.

>tell about hell
You can't see any such thing.

* * *

>t hell
(addressing the fat guy)
What did you say, allen?

>t dude
What did you say, allen?

>talk
What do you want to talk to?

>talk dude
I didn't understand that sentence.

>ask dude
You can't see any such thing.

>ask fat dude
I didn't understand that sentence.

>t about hell
What did you say, allen?

* * *

>t hell
(addressing the fat guy)
What did you say, allen?

>ask fat about hell
What did you say, allen?

* * *

>pray
You shout, "For the love of God, get me out of here!"  You suddenly feel like you exist again... and look around you...

Rolling Plain
You are on a large grassy plain.   To the north you see a river and a wall, far in the distance.  To the east a large group of people seem to be chasing a banner.

A bronze Djinn Bottle is laying on the ground.

You can also see a fat guy here.

The fat man says, "I am Benito, I rescued you from the bottle.  What is your name?

You have nothing specific in mind to discuss with Benito right now.

>ask
What do you want to ask about?

>ask fat
What do you want to ask the fat guy about?

>ask fat hell
I didn't understand that sentence.

>ash hell
That's not a verb I recognise.

>t hell
(addressing the fat guy)
The fat guy does not respond.

>t hell
The fat guy does not respond.

>t about hell
The fat guy does not respond.

* * *

>ask about hell
The fat guy does not respond.

>ask fat about hell
The fat guy does not respond.

* * *

>pray
You shout, "For the love of God, get me out of here!"  You suddenly feel like you exist again... and look around you...

Rolling Plain
You are on a large grassy plain.   To the north you see a river and a wall, far in the distance.  To the east a large group of people seem to be chasing a banner.

A bronze Djinn Bottle is laying on the ground.

You can also see a fat guy here.

The fat man says, "I am Benito, I rescued you from the bottle.  What is your name?

You have nothing specific in mind to discuss with Benito right now.

>ask fat about hell
fat guy says, "We are dead and in hell."

>ask benito
You can't see any such thing.

>ask fat
What do you want to ask the fat guy about?

>examine fat
You ask the fat man who he is and he replies "I am Benito, I rescued you from the bottle."

>ask benito
What do you want to ask Benito about?

>ask benito about hell
What did you say, allen?

* * *

>ask fat about hell
fat guy says, "We are dead and in hell."

>ask benito about hell
You can't see any such thing.

>look fat guy
I only understood you as far as wanting to look.

* * *

>ask fat about hell
fat guy says, "We are dead and in hell."

>examine fat
You ask the fat man who he is and he replies "I am Benito, I rescued you from the bottle."

>ask benito about fish
Benito does not respond.

>t fish
Benito does not respond.

>t hell
Benito does not respond.

* * *

>pray
You shout, "For the love of God, get me out of here!"  You suddenly feel like you exist again... and look around you...

Rolling Plain
You are on a large grassy plain.   To the north you see a river and a wall, far in the distance.  To the east a large group of people seem to be chasing a banner.

A bronze Djinn Bottle is laying on the ground.

You can also see a fat guy here.

The fat man says, "I am Benito, I rescued you from the bottle.  What is your name?

You have nothing specific in mind to discuss with Benito right now.

>examine fat guy
You ask the fat man who he is and he replies "I am Benito, I rescued you from the bottle."

>ask about hell
(addressing Benito)
We are dead and in hell.

>ask about wanker
Benito does not respond.

>ask about noodles
Benito does not respond.

>w
You can't go that way.

>e
Banners
Benito trudges along behind you...

>ask about hell
(addressing Benito)
We are dead and in hell.

>t goof
Benito does not respond.

>ask about scooby
Benito does not respond.

>e
You can't go that way.

>w
Rolling Plain
A bronze Djinn Bottle is laying on the ground.

Benito trudges along behind you...

>ask about dude
(addressing Benito)
Benito does not respond.

>ask about hell
We are dead and in hell.

* * *

>examine fat guy
You ask the fat man who he is and he replies "I am Benito, I rescued you from the bottle."

>plugh
A hollow voice says "Fool".

>xyzzy
A hollow voice says "Fool".

>dsfa
That's not a verb I recognise.

>ask benito about hell
Benito says, "We are dead and in hell."

>kill benito
Violence isn't the answer to this one.

>smell
It smells fetid, with an acrid tinge, decay and sickly sweet perfume to cover the smells of death, orange blossoms mingled with hospital smells, but sickening all the same.

* * *

>examine fat guy
You ask the fat man who he is and he replies "I am Benito, I rescued you from the bottle."

>take fat guy
Benito resists your romantic notions...

>l
Rolling Plain
You are on a large grassy plain.  To the north you see a river and a wall, far in the distance.  To the east a large group of people seem to be chasing a kite.

A bronze Djinn Bottle is laying on the ground.

You can also see Benito here.

>e
Banners
In the distance, you can see hundreds of people chasing a banner.

A hugely obese woman is lying against a rock.

You can also see a large rock here.

Benito trudges along behind you...

>take rock
Benito resists your romantic notions...

>take obese
Benito resists your romantic notions...

>take anything
You can't see any such thing.

>take benito
Benito resists your romantic notions...

>take orange
You can't see any such thing.

>take obese
Benito resists your romantic notions...

>l
Banners
In the distance, you can see hundreds of people chasing a banner.

A hugely obese woman is lying against a rock.

You can also see Benito and a large rock here.

>take woman
Benito resists your romantic notions...

* * *

>pray
You shout, "For the love of God, get me out of here!"  You suddenly feel like you exist again... and look around you...

Rolling Plain
You are on a large grassy plain.   To the north you see a river and a wall, far in the distance.  To the east a large group of people seem to be chasing a banner.

A bronze Djinn Bottle is laying on the ground.

You can also see a fat guy here.

The fat man says, "I am Benito, I rescued you from the bottle.  What is your name?

You have nothing specific in mind to discuss with Benito right now.

>examine large
You can't see any such thing.

>examine fat man
I only understood you as far as wanting to examine the fat guy.

>examine fat
*** Run-time problem P11: Although Benito is allowed to have the property "description", no value was ever given, so it can't now be used.

You ask the fat man who he is and he replies "I am Benito, I rescued you from the bottle."

* * *

>pray
You shout, "For the love of God, get me out of here!"  You suddenly feel like you exist again... and look around you...

Rolling Plain
You are on a large grassy plain.   To the north you see a river and a wall, far in the distance.  To the east a large group of people seem to be chasing a banner.

A bronze Djinn Bottle is laying on the ground.

You can also see a fat guy here.

The fat man says, "I am Benito, I rescued you from the bottle.  What is your name?

You have nothing specific in mind to discuss with Benito right now.

>w
You can't go that way.

>e
Banners
In the distance, you can see hundreds of people chasing a banner.

A hugely obese woman is lying against the rock.

You can also see a large rock here.

fat guy trudges along behind you...

>examine tree
You see nothing special about the large tree.

>take tree
Taken.

>invent
That's not a verb I recognise.

>inventory
You are carrying:
  a large tree

>take benito
You can't see any such thing.

>take fat guy
fat guy resists your romantic notions...

* * *

>e
Banners
In the distance, you can see hundreds of people chasing a banner.

A hugely obese woman is lying against the rock.

You can also see a large rock here.

fat guy trudges along behind you...

>w
You ask the fat man who he is and he replies "I am Benito, I rescued you from the bottle.

"It is over now. God will not allow you back into the bottle. I cannot assure you that there will be nothing worse before you leave Hell. There will be much worse. But with faith and hope you will endure it, and you will be able to leave."

Rolling Plain
A bronze Djinn Bottle is laying on the ground.

Benito trudges along behind you...

>w
You can't go that way.

>e
Banners
A hugely obese woman is lying against the rock.

You can also see a large rock here.

Benito trudges along behind you...

* * *

>pray
You shout, "For the love of God, get me out of here!"  You suddenly feel like you exist again... and look around you...

Rolling Plain
You are on a large grassy plain.   To the north you see a river and a wall, far in the distance.  To the east a large group of people seem to be chasing a banner.

A bronze Djinn Bottle is laying on the ground.

You can also see a fat guy here.

The fat man says, "I am Benito, I rescued you from the bottle.  What is your name?

You have nothing specific in mind to discuss with Benito right now.

>e
Banners
In the distance, you can see hundreds of people chasing a banner.

A hugely obese woman is lying against the rock... a pink mound with hair trailing down one side. Five-hundred-odd pounds of woman sitting cross-legged in stinking mud. A swarm of gnats hums around her. She doesn't bother to swat them.

You can also see a large rock here.

Benito trudges along behind you...

>take obese
fat guy resists your romantic notions...

>take woman
You can't see any such thing.

>take man
You can't see any such thing.

>examine  benito
You can't see any such thing.

>examine benito
You can't see any such thing.

>examine fat guy
You ask the fat man who he is and he replies "I am Benito, I rescued you from the bottle."

>take woman
You can't see any such thing.

>l
Banners
In the distance, you can see hundreds of people chasing a banner.

A hugely obese woman is lying against  the rock.

You can also see Benito and a large rock here.

>look
Banners
In the distance, you can see hundreds of people chasing a banner.

A hugely obese woman is lying against  the rock.

You can also see Benito and a large rock here.

>take woman
You can't see any such thing.

>take obese
Benito resists your romantic notions...

>examine woman
You can't see any such thing.

>examine obese
You see nothing special about the obese lady.

>take obese
Benito resists your romantic notions...

>take lady
Benito resists your romantic notions...

* * *

>pray
You shout, "For the love of God, get me out of here!"  You suddenly feel like you exist again... and look around you...

Rolling Plain
You are on a large grassy plain.   To the north you see a river and a wall, far in the distance.  To the east a large group of people seem to be chasing a banner.

A bronze Djinn Bottle is laying on the ground.

You can also see a fat guy here.

The fat man says, "I am Benito, I rescued you from the bottle.  What is your name?

You have nothing specific in mind to discuss with Benito right now.

>talk to fat guy
You say hello to the fat guy.

You have nothing specific in mind to discuss with the fat guy right now.

>talk to fat
You are already talking to the fat guy.

>examine fat
You ask the fat man who he is and he replies "I am Benito, I rescued you from the bottle."

>l
Rolling Plain
You are on a large grassy plain.  To the north you see a river and a wall, far in the distance.  To the east a large group of people seem to be chasing a kite.

A bronze Djinn Bottle is laying on the ground.

You can also see Benito here.

>e
Banners
In the distance, you can see hundreds of people chasing a banner.

A hugely obese woman is lying against the rock.

You can also see a large rock here.

Benito trudges along behind you...

>take obese
I don't suppose the obese lady would care for that.

>take benito
Benito resists your romantic notions...

>talk to obese
You say hello to the obese lady.

You have nothing specific in mind to discuss with the obese lady right now.

* * *

>pray
You ask the fat man who he is and he replies "I am Benito, I rescued you from the bottle.

"It is over now. God will not allow you back into the bottle. I cannot assure you that there will be nothing worse before you leave Hell. There will be much worse. But with faith and hope you will endure it, and you will be able to leave."

>pray
You ask the fat man who he is and he replies "I am Benito, I rescued you from the bottle.

"It is over now. God will not allow you back into the bottle. I cannot assure you that there will be nothing worse before you leave Hell. There will be much worse. But with faith and hope you will endure it, and you will be able to leave."

* * *

>l
Rolling Plain
You are on a large grassy plain.  To the north you see a river and a wall, far in the distance.  To the east a large group of people seem to be chasing a kite.

A bronze Djinn Bottle is laying on the ground.

You can also see Benito here.

* * *

>pray
You shout, "For the love of God, get me out of here!"  You suddenly feel like you exist again... and look around you...

Rolling Plain
You are on a large grassy plain.   To the north you see a river and a wall, far in the distance.  To the east a large group of people seem to be chasing a banner.

A bronze Djinn Bottle is laying on the ground.

You can also see a fat guy here.

The fat man says, "I am Benito, I rescued you from the bottle.  What is your name?

You have nothing specific in mind to discuss with Benito right now.

>l
Rolling Plain
You are on a large grassy plain.  To the north you see a river and a wall, far in the distance.  To the east a large group of people seem to be chasing a banner.

A bronze Djinn Bottle is laying on the ground.

You can also see Benito and a large rock here.

>w
You can't go that way.

>e
Banners
In the distance, you can see hundreds of people chasing a banner.

A hugely obese woman is lying against the rock... a pink mound with hair trailing down one side. Five-hundred-odd pounds of woman sitting cross-legged in stinking mud. A swarm of gnats hums around her. She doesn't bother to swat them.

You can also see a large rock here.

Benito trudges along behind you...

>l
Banners
In the distance, you can see hundreds of people chasing a banner.

A hugely obese woman is lying against the rock... a pink mound with hair trailing down one side. Five-hundred-odd pounds of woman sitting cross-legged in stinking mud. A swarm of gnats hums around her. She doesn't bother to swat them.

You can also see Benito and a large rock here.

* * *

>pray
You shout, "For the love of God, get me out of here!"  You suddenly feel like you exist again... and look around you...

Rolling Plain
You are on a large grassy plain.   To the north you see a river and a wall, far in the distance.  To the east a large group of people seem to be chasing a banner.

A bronze Djinn Bottle is laying on the ground.

You can also see a fat guy here.

The fat man says, "I am Benito, I rescued you from the bottle.  What is your name?

You have nothing specific in mind to discuss with Benito right now.

>examine djinn
It is a blue glass bottle.   It looks like Barbara Eden should pop out of it, in a puff of pink smoke.  Instead we got you, go figure.

* * *

>pray
You shout, "For the love of God, get me out of here!"  You suddenly feel like you exist again... and look around you...

Rolling Plain
You are on a large grassy plain.   To the north you see a river and a wall, far in the distance.  To the east a large group of people seem to be chasing a banner.

A bronze Djinn Bottle is laying on the ground.

You can also see a fat guy here.

The fat man says, "I am Benito, I rescued you from the bottle.  What is your name?

You have nothing specific in mind to discuss with Benito right now.

>ask benito about escape
Benito says, "We must descend deeper and deeper into hell, at the center, is the way out!"

>say hello to benito
You are already talking to Benito.

>say goodbye to benito
You say goodbye to Benito.

>say hello to benito
You say hello to Benito.

You have nothing specific in mind to discuss with Benito right now.

>ask benito about fucking
Benito does not respond.

>ask benito about bottle
Benito does not respond.

* * *

>pray
You shout, "For the love of God, get me out of here!"  You suddenly feel like you exist again... and look around you...

Rolling Plain
You are on a large grassy plain.   To the north you see a river and a wall, far in the distance.  To the east a large group of people seem to be chasing a banner.

A bronze Djinn Bottle is laying on the ground.

You can also see a fat guy here.

The fat man says, "I am Benito, I rescued you from the bottle.  What is your name?

You have nothing specific in mind to discuss with Benito right now.

>tell benito fuck you
Benito does not respond.

>tell benito name
Benito does not respond.

>w
You can't go that way.

* * *

>pray
You shout, "For the love of God, get me out of here!"  You suddenly feel like you exist again... and look around you...

Rolling Plain
You are on a large grassy plain.   To the north you see a river and a wall, far in the distance.  To the east a large group of people seem to be chasing a banner.

A bronze Djinn Bottle is laying on the ground.

You can also see a fat guy here.

The fat man says, "I am Benito, I rescued you from the bottle.  What is your name?

You have nothing specific in mind to discuss with Benito right now.

>tell benito my name is fucker
Benito does not respond.

* * *

>pray
You shout, "For the love of God, get me out of here!"  You suddenly feel like you exist again... and look around you...

Rolling Plain
You are on a large grassy plain.   To the north you see a river and a wall, far in the distance.  To the east a large group of people seem to be chasing a banner.

A bronze Djinn Bottle is laying on the ground.

You can also see a fat guy here.

The fat man says, "I am Benito, I rescued you from the bottle.  What is your name?

You have nothing specific in mind to discuss with Benito right now.

>tell benito about name
That's a nice name

>tell benito about name is mark
Benito does not respond.

>tell benito about name
That's a nice name

* * *

>praay
That's not a verb I recognise.

>pray
You suddenly feel like you exist again... and look around you...

Rolling Plain
You are on a large grassy plain.

You can see a Djinn bottle (closed) and Benito here.

* * *

>north
You can move, or rather you can move?  There is no place to go!

>look
Bronze
All you can see is a featureless bronze nothingness.  You can't even see... yourself.

>shout
You shout, "for the love of God, get me out of here!"  You suddenly feel like you exist again... and look around you...

Rolling Plain
You are on a large grassy plain.  To the north you see a river and a wall, far in the distance.  To the east a large group of people seem to be chasing a kite.

A bronze Djinn Bottle.

You can also see a heavyset man here.

>open bottle
That's not something you can open.

>take all
Djinn bottle: Taken.
heavyset man: Taken.
sky: That's hardly portable.

>inventory
You are carrying:
  a heavyset man
  a Djinn bottle

>examine man
You ask the heavyset man who he is and he replies "I am Benito, I rescued you from the bottle."

>l
Rolling Plain
You are on a large grassy plain.  To the north you see a river and a wall, far in the distance.  To the east a large group of people seem to be chasing a kite.

>north
You can't go that way.

>east
You can't go that way.

>look at sky
The sky is cold grey.

* * *

>yell
You shout, "For the love of God, get me out of here!"  You suddenly feel like you exist again... and look around you...

Rolling Plain
You are on a large grassy plain.  To the north you see a river and a wall, far in the distance.  To the east a large group of people seem to be chasing a kite.

A bronze Djinn Bottle is laying on the ground.

A fat man is here.

>examine fat
You ask the fat man who he is and he replies "I am Benito, I rescued you from the bottle."

>l
Rolling Plain
You are on a large grassy plain.  To the north you see a river and a wall, far in the distance.  To the east a large group of people seem to be chasing a kite.

A bronze Djinn Bottle is laying on the ground.

Benito is here.

>take all
Djinn bottle: Taken.
Benito: Benito resists your romantic notions...
sky: That's hardly portable.

>w
You can't go that way.

>e
Banners
Benito follows dutify behind you...

>smell
You smell nothing unexpected.

* * *

>shout
You scream. You can hear the scream but nothing answers...

* * *

>take bottle
Taken.

>l
Rolling Plain
You are on a large grassy plain.

You can see a heavyset man here.

>talk to man
That's not a verb I recognise.

>examine heavyset
You ask the heavyset man who he is and he replies Call me Benito, I rescued you from the bottle.

* * *

>shout
You scream. You can hear the scream but nothing answers...

>e
Kite Chase
heavyset man follows dutify behind you...

>examine man
You ask the heavyset man who he is and he replies "I am Benito, I rescued you from the bottle."

>l
Kite Chase
You can see Benito here.

>exits
That's not a verb I recognise.

>w
Rolling Plain
A bronze Djinn Bottle.

Benito follows dutify behind you...

* * *

>shout
You scream. You can hear the scream but nothing answers...

>look
Bronze
All you can see is a featureless bronze nothingness.  You can't even see... yourself.

* * *

>scream
You nothing. You can hear the scream but nothing answers...

>shout
You shout, "For the love of God, get me out of here!"  You suddenly feel like you exist again... and look around you...

Rolling Plain
You are on a large grassy plain.  To the north you see a river and a wall, far in the distance.  To the east a large group of people seem to be chasing a kite.

A bronze Djinn Bottle.

You can also see a heavyset man here.

>e
Kite Chase
Benito follows dutify behind you...

>l
Kite Chase
You can see a heavyset man here.

* * *

>scream
You nothing. You can hear the scream but nothing answers...

>r
That's not a verb I recognise.

>e
Banners
In the distance, you can see hundreds of people chasing a banner.

A hugely obese woman is lying against the rock... a pink mound with hair trailing down one side. Five-hundred-odd pounds of woman sitting cross-legged in stinking mud. A swarm of gnats hums around her. She doesn't bother to swat them.

You can also see a large rock here.

Benito trudges along behind you...

* * *

>look at sky
You can move, or rather you can move?  There is no place to go!

>wait
You can move, or rather you can move?  There is no place to go!

>shout
You shout, "For the love of God, get me out of here!"  You suddenly feel like you exist again... and look around you...

Rolling Plain
You are on a large grassy plain.  To the north you see a river and a wall, far in the distance.  To the east a large group of people seem to be chasing a kite.

A bronze Djinn Bottle is laying on the ground.

You can also see a heavyset man here.

>take heavyset
Taken.

>e
Kite Chase

>l
Kite Chase

>w
Rolling Plain
A bronze Djinn Bottle is laying on the ground.

>examine heavyset
You ask the heavyset man who he is and he replies "I am Benito, I rescued you from the bottle."

* * *

>die
That's not a verb I recognise.

>shout
You shout, "For the love of God, get me out of here!"  You suddenly feel like you exist again... and look around you...

Rolling Plain
You are on a large grassy plain.  To the north you see a river and a wall, far in the distance.  To the east a large group of people seem to be chasing a kite.

A bronze Djinn Bottle is laying on the ground.

heavyset man  is here.

>examine man
You ask the heavyset man who he is and he replies "I am Benito, I rescued you from the bottle."

>look
Rolling Plain
You are on a large grassy plain.  To the north you see a river and a wall, far in the distance.  To the east a large group of people seem to be chasing a kite.

A bronze Djinn Bottle is laying on the ground.

Benito  is here.

* * *

>l
Bronze
All you can see is a featureless bronze nothingness.  You can't even see... yourself.

>yell
You shout, "For the love of God, get me out of here!"  You suddenly feel like you exist again... and look around you...

Rolling Plain
You are on a large grassy plain.  To the north you see a river and a wall, far in the distance.  To the east a large group of people seem to be chasing a kite.

A bronze Djinn Bottle is laying on the ground.

heavyset man is here.

>n
Wall
No matter how far you walk, the wall never seems to get any closer...

heavyset man follows dutify behind you...

>n
You can't go that way.

>look at sky
The sky is cold grey.  Not cloudy, just flat and featureless.

* * *

>l
Bronze
All you can see is a featureless bronze nothingness.  You can't even see... yourself.

>scream
You shout, "For the love of God, get me out of here!"  You suddenly feel like you exist again... and look around you...

Rolling Plain
You are on a large grassy plain.  To the north you see a river and a wall, far in the distance.  To the east a large group of people seem to be chasing a kite.

A bronze Djinn Bottle is laying on the ground.

A fat man is here.

>talk to fat man
That's not a verb I recognise.

>look at fat man
You ask the fat man who he is and he replies "I am Benito, I rescued you from the bottle."

* * *

>smell
It smells foetid, with an acrid tinge, decay and sickly sweet perfume to cover the smells of death, orange blossoms mingled with hospital smells, but sickening all the same.

fat guy trudges along behind you...

>yell
You shout at the top of your lungs.  Nothing interesting happens...

>smell
You can move, or rather you can move?  There is no place to go!

>shout
You shout at the top of your lungs.  Nothing interesting happens...

>yell
You shout at the top of your lungs.  Nothing interesting happens...

>pray
You shout at the top of your lungs.  Nothing interesting happens...

>restart
Are you sure you want to restart?

>yes
You are dead.  This is a unique way to begin.  Item: "Science Fiction Author falls to death during drinking contest at Science Fiction Convention."

Inferno
An Interactive Fiction by Mark Firestone
Release 1 / Serial number 090109 / Inform 7 build 5U92 (I6/v6.31 lib 6/12N) SD

Bronze
All you can see is a featureless bronze nothingness.  You can't even see... yourself.

>shout
You shout at the top of your lungs.  Nothing interesting happens...

>pray
You shout at the top of your lungs.  Nothing interesting happens...

* * *

>wait
You can move, or rather you can move?  There is no place to go!

>pray
You shout, "For the love of God, get me out of here!"  You suddenly feel like you exist again... and look around you...

Rolling Plain
You are on a large grassy plain.  To the north you see a river and a wall, far in the distance.  To the east a large group of people seem to be chasing a kite.

A bronze Djinn Bottle is laying on the ground.

fat guy is here.

>examine fat y
I only understood you as far as wanting to examine the fat guy.

>examine fat
You ask the fat man who he is and he replies "I am Benito, I rescued you from the bottle."

* * *

>l
Rolling Plain
You are on a large grassy plain.  To the north you see a river and a wall, far in the distance.  To the east a large group of people seem to be chasing a kite.

A bronze Djinn Bottle is laying on the ground.

Benito is here.

>n
Wall
No matter how far you walk, the wall never seems to get any closer...

Benito trudges along behind you...

* * *

>n
You continue walking north...

>n
Benito says, "We could walk for eternity and never reach that wall, and we have eternity."

 You continue walking north...

>n
You continue walking north...

>n
Benito says, "I know the real way to escape.  Why not ask me..."

 You continue walking north...

>n
You continue walking north...

* * *

>n
Benito says, "We could walk for eternity and never reach that wall, and we have eternity."

 You continue walking north...

>n
Benito says, "We could walk for eternity and never reach that wall, and we have eternity."

 You continue walking north...

* * *

>n
You continue walking north...

>n
Benito says,"Very well, continue towards the wall, until you convince yourself it can never be reached."

 You continue walking north...

>ask benito about escape
Benito does not respond.

* * *

>prey
That's not a verb I recognise.

>pray
You shout, "For the love of God, get me out of here!"  You suddenly feel like you exist again... and look around you...

Rolling Plain
You are on a large grassy plain.  To the north you see a river and a wall, far in the distance.  To the east a large group of people seem to be chasing a kite.

A bronze Djinn Bottle is laying on the ground.

You can also see a fat guy here.

>talk to fat guy
You say hello to the fat guy.

You have nothing specific in mind to discuss with the fat guy right now.

>examine fat guy
You ask the fat man who he is and he replies "I am Benito, I rescued you from the bottle."

>examine fat guy
A large, powerful man with a square jaw.  He projects an aura of authority.

>l
Rolling Plain
You are on a large grassy plain.  To the north you see a river and a wall, far in the distance.  To the east a large group of people seem to be chasing a kite.

A bronze Djinn Bottle is laying on the ground.

You can also see Benito here.

>w
You can't go that way.

>e
Banners
In the distance, you can see hundreds of people chasing a banner.

A hugely obese woman is lying against a rock.

You can also see a large rock here.

Benito trudges along behind you...

* * *

>take rock
Benito resists your romantic notions...

>take
What do you want to take?

>take obese
Benito resists your romantic notions...

* * *

>pray
You shout, "For the love of God, get me out of here!"  You suddenly feel like you exist again... and look around you...

Rolling Plain
You are on a large grassy plain.  To the north you see a river and a wall, far in the distance.  To the east a large group of people seem to be chasing a kite.

A bronze Djinn Bottle is laying on the ground.

You can also see a fat guy here.

>examine guy
You ask the fat man who he is and he replies "I am Benito, I rescued you from the bottle."

>examine guy
A large, powerful man with a square jaw.  He projects an aura of authority.

>w
You can't go that way.

>e
Banners
In the distance, you can see hundreds of people chasing a banner.

A hugely obese woman is lying against the rock.

You can also see a large rock here.

Benito trudges along behind you...

>examine obese
You see nothing special about the obese lady.

>examine woman
You can't see any such thing.

>take obese
Benito resists your romantic notions...

>take woman
You can't see any such thing.

* * *

>talk
What do you want to talk to?

>talk to benito
You can't see any such thing.

>pray
You shout, "For the love of God, get me out of here!"  You suddenly feel like you exist again... and look around you...

Rolling Plain
You are on a large grassy plain.  To the north you see a river and a wall, far in the distance.  To the east a large group of people seem to be chasing a kite.

A bronze Djinn Bottle is laying on the ground.

You can also see a fat guy here.

* * *

>talk to fat guy
You say hello to the fat guy.

You have nothing specific in mind to discuss with the fat guy right now.

>talk to woozie
You can't see any such thing.

* * *

>repent
You shout, "For the love of God, get me out of here!"  You suddenly feel like you exist again... and look around you...

Rolling Plain
You are on a large grassy plain.   To the north you see a river and a wall, far in the distance.  To the east a large group of people seem to be chasing a banner.

A bronze Djinn Bottle is laying on the ground.

You can also see a fat guy here.

The fat man says, "I am Benito, I rescued you from the bottle.  What is your name?

You have nothing specific in mind to discuss with Benito right now.

* * *

>look isaac
You see nothing special about Isaac Asimov.

* * *

>talk to issac
You can't see any such thing.

>talk to asimov
You say hello to Isaac Asimov.

You have nothing specific in mind to discuss with Isaac Asimov right now.

>examine asimov
You see nothing special about Isaac Asimov.

* * *

>east
Window Ledge

>sit on the window
You can't, since the window leads nowhere.

>listen
You hear nothing unexpected.

* * *

>east
Window Ledge

>l
Window Ledge

>west
Con-Suite
The Con-Suite is on the tenth floor of the some hotel or other.  You've been drinking, and can't quite remember which one.  On the east side of the room is an open window.

Isaac Asimov is here, surrounded by a gaggle of fans, holding forth in a somewhat ill fitting suit.

>sit on the window ledge
I only understood you as far as wanting to sit on the window.

>sit on the window
Window Ledge

>w
Con-Suite
The Con-Suite is on the tenth floor of the some hotel or other.  You've been drinking, and can't quite remember which one.  On the east side of the room is an open window.

Isaac Asimov is here, surrounded by a gaggle of fans, holding forth in a somewhat ill fitting suit.

>drink
(Isaac Asimov)
There's nothing suitable to drink here.

* * *

>look window
You see nothing special about the window.

>r
That's not a verb I recognise.

>e
Open Air

>w
Con-Suite
The Con-Suite is on the tenth floor of the some hotel or other.  You've been drinking, and can't quite remember which one.  On the east side of the room is an open window.

Isaac Asimov is here, surrounded by a gaggle of fans, holding forth in a somewhat ill fitting suit.

>sit on window
Open Air

* * *

>inventory
You are carrying:
  a glass (full)

>drink
(the glass (full))
You drink a long draught.

>drink
(the glass (partly drained))
You drink a long draught.

>drink
(the glass (empty))
You're out of beer.

* * *

>drink bottle
There's nothing suitable to drink here.

>drink bottle of rum
There's nothing suitable to drink here.

* * *

>examine asimov
You see nothing special about Isaac Asimov.

* * *

>examine adolescent
You see nothing special about the Middle-aged Adolescent.

>look adolecent
You can't see any such thing.

>plugh
A hollow voice says "Fool".